###############
p #       #   #
# # # # # # # #
# # # # # # # #
# # # ### # # #
# # #   # # # #
# # ##### # # #
#       #   # g
###############